{
    "height": 16,
    "width": 8,
    "wall_grid":
    [
        [4,4,4,3,3,4,4,4],
        [4,0,0,0,0,0,0,4],
        [4,0,0,0,0,0,0,4],
        [4,0,0,0,0,0,0,4],
        [4,0,0,0,0,0,0,4],
        [4,0,0,0,0,0,0,4],
        [4,0,0,0,0,0,0,4],
        [4,0,0,0,0,0,0,4],
        [4,4,4,0,0,4,4,4],
        [4,0,0,0,0,0,0,4],
        [4,0,0,0,0,0,0,4],
        [4,0,0,0,0,0,0,4],
        [4,0,0,0,0,0,0,4],
        [4,0,0,0,0,0,0,4],
        [4,0,0,0,0,0,0,4],
        [4,4,4,4,4,4,4,4]
    ],
    "ceil_grid":
    [
        [4,4,4,4,4,4,4,4],
        [4,8,8,8,8,8,8,4],
        [4,8,8,8,8,8,8,4],
        [4,8,8,8,8,8,8,4],
        [4,8,8,8,8,8,8,4],
        [4,8,8,8,8,8,8,4],
        [4,8,8,8,8,8,8,4],
        [4,4,4,4,4,4,4,4],
        [4,4,4,4,4,4,4,4],
        [4,1,8,8,8,8,1,4],
        [4,8,1,8,8,1,8,4],
        [4,8,8,1,1,8,8,4],
        [4,8,8,1,1,8,8,4],
        [4,8,1,8,8,1,8,4],
        [4,1,8,8,8,8,1,4],
        [4,4,4,4,4,4,4,4]
    ],
    "floor_grid":
    [
        [5,5,5,5,5,5,5,5],
        [5,5,5,5,5,5,5,5],
        [5,5,7,7,7,7,5,5],
        [5,5,7,5,5,7,5,5],
        [5,5,7,5,5,7,5,5],
        [5,5,7,7,7,7,5,5],
        [5,5,5,5,5,5,5,5],
        [5,5,5,5,5,5,5,5],
        [5,5,5,5,5,5,5,5],
        [5,5,5,5,5,5,5,5],
        [5,5,1,1,1,1,5,5],
        [5,5,1,5,5,1,5,5],
        [5,5,1,5,5,1,5,5],
        [5,5,1,1,1,1,5,5],
        [5,5,5,5,5,5,5,5],
        [5,5,5,5,5,5,5,5]
    ],
    "entities": [
        {
            "sprite": "04_soldier",
            "x": 5.5,
            "y": 3.5,
            "dir_x": 0.0,
            "dir_y": 1.0
        }, {
            "sprite": "03_pillar",
            "x": 5.5,
            "y": 13.5,
            "collidable": true,
            "collision_radius": 0.5
        }, {
            "sprite": "03_pillar",
            "x": 2.5,
            "y": 13.5,
            "collidable": true,
            "collision_radius": 0.5
        }, {
            "sprite": "03_pillar",
            "x": 5.5,
            "y": 10.5,
            "collidable": true,
            "collision_radius": 0.5
        }, {
            "sprite": "03_pillar",
            "x": 2.5,
            "y": 10.5,
            "collidable": true,
            "collision_radius": 0.5
        }, {
            "sprite": "02_greenlight",
            "x": 3.5,
            "y": 3.5
        }, {
            "sprite": "05_cacodemon",
            "x": 3.5,
            "y": 3.5
        }
    ]
}
