{
    "height": 8,
    "width": 16,
    "wall_grid":
    [
        [4,4,4,3,3,4,4,4],
        [4,0,0,0,0,0,0,4],
        [4,0,0,0,0,0,0,4],
        [4,0,0,0,0,0,0,4],
        [4,0,0,0,0,0,0,4],
        [4,0,0,0,0,0,0,4],
        [4,0,0,0,0,0,0,4],
        [4,0,0,0,0,0,0,4],
        [4,4,4,0,0,4,4,4],
        [4,0,0,0,0,0,0,4],
        [4,0,0,0,0,0,0,4],
        [4,0,0,0,0,0,0,4],
        [4,0,0,0,0,0,0,4],
        [4,0,0,0,0,0,0,4],
        [4,0,0,0,0,0,0,4],
        [4,4,4,4,4,4,4,4]
    ],
    "ceil_grid":
    [
        [4,4,4,4,4,4,4,4],
        [4,7,7,7,7,7,7,4],
        [4,7,7,7,7,7,7,4],
        [4,7,7,7,7,7,7,4],
        [4,7,7,7,7,7,7,4],
        [4,7,7,7,7,7,7,4],
        [4,7,7,7,7,7,7,4],
        [4,4,4,4,4,4,4,4],
        [4,4,4,4,4,4,4,4],
        [4,0,7,7,7,7,0,4],
        [4,7,0,7,7,0,7,4],
        [4,7,7,0,0,7,7,4],
        [4,7,7,0,0,7,7,4],
        [4,7,0,7,7,0,7,4],
        [4,0,7,7,7,7,0,4],
        [4,4,4,4,4,4,4,4]
    ],
    "floor_grid":
    [
        [4,4,4,4,4,4,4,4],
        [4,4,4,4,4,4,4,4],
        [4,4,6,6,6,6,4,4],
        [4,4,6,4,4,6,4,4],
        [4,4,6,4,4,6,4,4],
        [4,4,6,6,6,6,4,4],
        [4,4,4,4,4,4,4,4],
        [4,4,4,4,4,4,4,4],
        [4,4,4,4,4,4,4,4],
        [4,4,4,4,4,4,4,4],
        [4,4,0,0,0,0,4,4],
        [4,4,0,4,4,0,4,4],
        [4,4,0,4,4,0,4,4],
        [4,4,0,0,0,0,4,4],
        [4,4,4,4,4,4,4,4],
        [4,4,4,4,4,4,4,4]
    ]
}
