{
    "height": 8,
    "width": 16,
    "wall_grid":
    [
        [4,4,4,3,3,4,4,4],
        [4,0,0,0,0,0,0,4],
        [4,0,0,0,0,0,0,4],
        [4,0,0,0,0,0,0,4],
        [4,0,0,0,0,0,0,4],
        [4,0,0,0,0,0,0,4],
        [4,0,0,0,0,0,0,4],
        [4,0,0,0,0,0,0,4],
        [4,4,4,0,0,4,4,4],
        [4,0,0,0,0,0,0,4],
        [4,0,0,0,0,0,0,4],
        [4,0,0,0,0,0,0,4],
        [4,0,0,0,0,0,0,4],
        [4,0,0,0,0,0,0,4],
        [4,0,0,0,0,0,0,4],
        [4,4,4,4,4,4,4,4]
    ],
    "ceil_grid":
    [
        [4,4,4,4,4,4,4,4],
        [4,8,8,8,8,8,8,4],
        [4,8,8,8,8,8,8,4],
        [4,8,8,8,8,8,8,4],
        [4,8,8,8,8,8,8,4],
        [4,8,8,8,8,8,8,4],
        [4,8,8,8,8,8,8,4],
        [4,4,4,4,4,4,4,4],
        [4,4,4,4,4,4,4,4],
        [4,1,8,8,8,8,1,4],
        [4,8,1,8,8,1,8,4],
        [4,8,8,1,1,8,8,4],
        [4,8,8,1,1,8,8,4],
        [4,8,1,8,8,1,8,4],
        [4,1,8,8,8,8,1,4],
        [4,4,4,4,4,4,4,4]
    ],
    "floor_grid":
    [
        [5,5,5,5,5,5,5,5],
        [5,5,5,5,5,5,5,5],
        [5,5,6,6,6,6,5,5],
        [5,5,6,5,5,6,5,5],
        [5,5,6,5,5,6,5,5],
        [5,5,6,6,6,6,5,5],
        [5,5,5,5,5,5,5,5],
        [5,5,5,5,5,5,5,5],
        [5,5,5,5,5,5,5,5],
        [5,5,5,5,5,5,5,5],
        [5,5,1,1,1,1,5,5],
        [5,5,1,5,5,1,5,5],
        [5,5,1,5,5,1,5,5],
        [5,5,1,1,1,1,5,5],
        [5,5,5,5,5,5,5,5],
        [5,5,5,5,5,5,5,5]
    ]
}
